111111111111111111111111111111111111111111111111111111111111
1M000C000100C000000000M0000000C00000000C0000C0000M000000CM01
10000M00000000000000000C00M0000C001000M00000000M0C00P0000001
1000000C00M0CC000C000M0C00000C0000M000000C000M00000000000001
10C0000000000000100000000000000000C00000M0C0000E0C00M0000001
111111111111111111111111111111111111111111111111111111111111