111111111111111111111111111
111111111CCCCCCCCCCCCCCCCC1
11C1CCCC1C111111111111111C1
11C1C11C1C1CCCCCCCCCCCCC1C1
1CCCC11C1C1C11111111111C1C1
1C11111CCC1CCCCCCCCCCCCC1C1
1CCCC111111C1C11111C1C1C1C1
1111CCCCCC1C1C1ECCCCCCCC1C1
11111111CC1C1C111111111C1C1
1CCCCCCCCC1C1CCCCCCCCCCC1C1
1C1C1C1C1C1C1111111111111C1
1CCCCCCCCC1CCCCCCCCCCCCCCC1
1C1111111111111111111111111
1CCCCCCCCCCCCCCCCCCCCCCCCP1
111111111111111111111111111