1111111111111
11111P11111C1
10000M10001M1
1011101000C01
1C100M0001101
1000111100001
1010111100111
1010M11CM0001
10C1011111001
111100M0C10E1
1111111111111