11111111111111111111
10C00001000100010001
10000001111111111111
111110000000000000C1
10001000000000000001
10001000111111111111
1000E000000000000001
10001C00111111111111
1111100000C000000001
10000000111111111111
10000000000000C00001
11111000111111111111
10000000000000000001
1111100C111111111111
1000000000000C000001
11111000111111111111
100C0000000C000000P1
11111111111111111111