1111111111
1000001001
1EC0100001
1111110011
1P00C00101
1111111111